10 10
0 1 2 3 3 0 1 2 2 2
2 1 2 4 3 2 1 3 3 3
2 2 4 5 3 2 4 4 3 3
3 3 4 6 4 2 3 3 3 3
2 2 3 3 5 3 3 2 3 3
2 1 1 3 4 2 2 3 4 4
2 0 0 1 2 1 1 1 1 1
1 0 1 2 0 2 3 2 3 3
2 2 2 1 1 0 2 3 3 4
4 3 2 2 1 1 2 4 5 5
